R 600 400
C 46, 52, 64 
F 94, 129, 172 


111111111111111
100000000000001
1444411111111111
10010000000000011111111111111
10111111111111100000001010001
10000000001100011100011110001
11110111111111011100010000001
11110111111111011100010010001
11000000110101011100010010001
10002000011000000001100010001
1000N000000000000111000010001
11000000110101011111011110001
11110111111101000000011110001
11111111111111111111111111111