R 1600 1400
C 46, 52, 64
F 216, 222, 233

1111111111111111111111111
1000100010001000100010001
1010101010101010101010101
1010101010101010101010101
1010101010101010101010101
1010000000000000000000101
10E0000000000000000000001
1010000000000000000000101
1010101010101010101010101
1010101010101010101010101
1010001N00100010001000101
1111111111111111111111111
